11111
1P0E1
10C01
10001
11111
