11111
1P1E1
10C11
10001
11111
